{
	"numTilesX":13,
	"numTilesY":10,
	"size": [64, 64],
	"start": [16, 32],
	"tileNames": ["", "tile01", "tile02", "tile03", "tile04", "tile05", "tile06"],
	"tiles": [
			  0, 0, 0, 0, 0, 0, 0, 0, 0, 0, 0, 0, 0,
			  2, 0, 0, 0, 0, 0, 0, 0, 0, 0, 0, 0, 2,
			  2, 1, 0, 0, 0, 0, 0, 0, 1, 1, 1, 1, 2,
			  2, 0, 0, 1, 1, 1, 0, 0, 0, 0, 4, 4, 2,
			  2, 0, 0, 0, 0, 4, 1, 0, 0, 0, 0, 4, 2,
			  2, 1, 0, 0, 0, 0, 4, 1, 1, 0, 0, 0, 2,
			  2, 4, 1, 0, 0, 0, 0, 4, 4, 1, 0, 0, 2,
			  2, 4, 4, 1, 0, 0, 0, 6, 6, 4, 4, 0, 2,
			  2, 2, 2, 2, 2, 2, 2, 2, 2, 2, 2, 2, 2,
			  3, 3, 3, 3, 3, 3, 3, 3, 3, 3, 3, 3, 3
			  ]
}